cuaics.txt = Commonly Used Abbreviations in Computer Science
============================================================

1 Cycle=1Up+1Down
ACLKEN=AXI clock enable signal
active-HIGH=is active when the signal is high (1 in bit)
active-LOW=is active when the signal is low (0 in bit)
ALU=Arithmetic Logical Unit
AMBA=Advanced Microprocessor Bus Architecture
APB=Advanced Peripheral Bus
ARM architecture v7-A = instruction set
asserted=the signal is in it's active state
ATB=Advanced Trace Bus
ATCLK= ATB clock
ATPG=Automatic Test Pattern Generation
AXI=Advanced Extensible Interface
benign state
benign values
BIU=Buffer Interface Unit
BTB=
CLK=clock signal
CP14=
CP15=
CSG=Configuration and Sign-Off Guide (The CSG is a confidential book that is only available to licensees)
CTICONTROL=CTI Control Register
CTI=Cross Trigger Interface
deassertion
DFF=Delay Flip-Flop
DFT=Design For Test
ECC=Error Correction Code
ETM=Embedded Trace Macrocell
FIQ=
FPEXC=Floating-point Exception Register
GHB=
IEEE 754=IEEE Standard for Binary Floating Point Arithmetic.
IEM=Intelligent Energy Management
IPU=Image Processing Unit
IPU=Interconnect Processing Unit
IRQ=
L1RSTDISABLE=L1 cache Reset Disable
L2EN=
L2RSTDISABLE=L2 cache Reset Disable
Lower-case n=Denotes an active-LOW signal
MBIST=Memory Built-In Self Test
MMU=Memory Management Unit
nFIQ=
nIRQ=
PLE=PreLoad Engine ?
PWM=pulse-width modulation
RTL=Register Transfer Level
SIMD=Single Instruction Multiple Data
SoC=System-on-Chip
SPMI=System Power Management Interface
ThumbEE=Thumb Execution Environment
TLBs=Translation Look-aside Buffers
TRM=Technical Reference Manual
UAL=Unified Assembler Language
VFP=Vector Floating Point
WFI=Wait For Interrupt
